1,2,3,4,5,6,7,8,1,2
10,11,12,13,14,15,16,17,10,11
19,20,21,21,23,24,25,26,19,20
28,29,30,31,32,33,34,35,28,29
27,27,27,27,27,27,27,27,27,27
27,27,27,27,27,27,27,27,27,27
27,27,27,27,27,27,27,27,27,27
27,27,27,27,27,27,27,27,27,27
27,27,27,27,27,27,27,27,27,27
27,27,27,27,27,27,27,27,27,27
27,27,27,27,27,27,27,27,27,27
27,27,27,27,27,27,27,27,27,27
