4,5,6,7,8,4,5,6,7,8
8,9,10,11,12,8,9,10,11,12
12,13,14,15,12,12,13,14,15,12
4,1,2,3,4,4,1,2,3,4
4,5,6,7,8,4,5,6,7,8
8,9,10,11,12,8,9,10,11,12
4,1,2,3,4,4,1,2,3,4
4,5,6,7,8,4,5,6,7,8
8,9,10,11,12,8,9,10,11,12
12,13,14,15,12,12,13,14,15,12
